************
* ** ** ** *
* ** ** ** *
* ** ** ** *
* ** ** ** *
*          *
* ** ** ** *
* ** ** ** *
* ** ** ** *
*          *
* ** ** ** *
* ** ** ** *
* ** ** ** *
*          *
************
