***************
* **    **    *
* ** *  **    *
* ** *  **    *
* ** *  **    *
*             *
* ** *  **    *
* ** *  **    *
* ** *  **    *
*             *
* ** *  **    *
* ** *  **    *
* ** *  **    *
*             *
***************
